1111111111111111111111111111111111111111111111111111111111111111111111111111111111111111111111111111
1EEEEEEEEEEEEEEEEEEEEEEEEEcEEEEEEEEEEEEEEEEEEEEEEEEEEEEEEEEEEEEEEEEEEEEMMMMMMMMMMMMMMMMMMMMMMMMMrrM1
1EEEEEEEEEEEEEEEEEEEEEEEEEcEEEEEEEEEEEEEEEEEEEEEEEHHHHHHHHHHEEEEEEEEEEMMMMMMMMMMMMMMMMMMMMMMMrrrrMM1
1EEEEEEEEEEEEEEEEEEEEEEcccEEEEEEEEEEEEEEEEEEEEEEEEHFFFFFFFFHEEEEEEEEEMM0MMMMMMMMMMMMMMMMMMMrrrMMMMM1
1EEEEEEEEEEEEEEEEEEEEEccEEEEEEEEEEEEEEEEEEEEEEEEEEHFFFFFFFFHEEEEEEMMMM0MM0MMMMMMMMMMMMMMMMMrrMMMMMM1
1EEEEEEEEEEEEEEEEEEEEcEEEEEEEEEEEEEEEEEEEEEEEEEEEEHFFFFFFFFHEEEEEEMMMMMM0MMMMMMMMMMMMMMMMMrrrMMMMMM1
1EEEEEEEEEEEEEEEEEEEccEEEEEEEEEEEEEEEEEEEEEEEEEEEEHFFFFFFFFHEEEEEEMMMMMMMMMMMMMMMMMMMMMMrrrrMMMMMMM1
1EEEEEEEEEEEEEEEEcccEEEEEEEEEEEEEEEEEEEEEEEEEEEEEEHFFFFFFFFHEEEEEEMMMMMMMMMMMMMMMMMMMMMrrMMMMMMMMMM1
1EEEEEEEEEEEEEEEccEEE11EEEEEEEEEEEEEEEEEEEEEEEEEEEHFFFFFFFFHEEEEEEMMMMMMMMMMMMMMMMMMMMrrMMMMMMMMMMM1
1EEEEEEEEEEEEEEccEEEEE111EEEEEEEEEEEEEEEEEEEEEEEEEHFFFFFFFFHEEEEEEMMMMMMMMMMMMMMMMMMMMrrMMMMMMMMMMM1
1EEEEEEEEEEEEcccEEEEEEEE11EEEEEEEEEEEEEEEEEEEEE1EEHFFFFFFFFHEEEEEEMMMMMMMMMMMMMMMMMMMMrrMMMMMMMMMMM1
1EEEEEEEEEEEccEEEEEEEEEEE111EEEEEEEEEEEEEEEEEE11EEHFFFFFFFFHEEEEEEMMMMMMMMMMMMMMMMMMMMrrMMMMMMMMMMM1
1EEEEEEEEEEccEEEEEEEEEEEEEE11EEEEEEEEEEEEEEEE11EEEHHHHHHHHHHEEEEEMMMMMMMMMMMMMMMMMMMMrrrMMMMMMMMMMM1
1EEEEEEEEEccEEEEEEEEEEEEEEEE11EEEEEEEEEEEEEE11EEEEEEEEEEEEEEEEEEEMMMMMMMMMMMMMMMMMMMMrrMMMMMMMMMMMM1
1ccccccccccEEEEEEEEEEEEEEEEEE11EEEEEEEEEEEE11EEEEEEEEEEEEEEEEEEEMMMMMMMMMMMMMMMMMMMrrrrMMMMMMMMMMMM1
1EEEEEEEEEEEEHHHHHHHHHHEEEEEE11EEEEEEEEEE111EEEEEEEEEEEEEEEEEEMMMMMMMMMM111111111BBBBBBBB-----MMMMM1
1EEEEEEEEEEEEHFFFFFFFFHEEEEEE11EEEEEEEEE11EEEEEEEEEEEEEEEEEEEEMMMMMMMMMM111111111BBBBBBBB-----MMMMM1
1EEEEEEEEEEEEHFFFFFFFFHEEEEEE11EEEEEEEE11EEEEEEEEEEEEEEEEEEEEMMMMMMMMMMM1MMMMMMMMMMMrMMMMMMM--MMMMM1
1EEEEEEEEEEEEHFFFFFFFFHEEEEEE11EEEEEEE11EEEEEEEEEEEEEEEEEEEE1111111111111MMRMMMMMMMMrMMMMMMM--MMMMM1
1EEEEEEEEEEEEHFFFFFFFFHE11111111111111111111EEEEEEEEEEEEEEE11111111111111SSSSSSSSSSSSMMMMMMM--MMMMM1
1EEEEEEEEEEEEHFFFFFFFFHE1111111111111111111111111111111111111MMMMMMMMMMMSSSSSSSSSSSSSSMMMMMM--MMMMM1
1EEEEEEEEEEEEHFFFFFFFFHEEEEEEE1EEEEEEEEEEEEE111111111111111MMHHHHHHHHMMRSSSSSSSSSSSSSSMMMMMM--MMMMM1
1EEEEEEEEEEEEHFFFFFFFFHEEEEEEE11EEEEEEEEEEEEEEEEEEE11EEMMMMMMHFFFFFFHMMRSSSSSSSSSSSSSSMMMMMM--MMMMM1
1EEEEEEEEEEEEHFFFFFFFFHEEEEEEEE11EEEEEEEEEEEEEEEEEE11EMMMMMMMHFFFFFFHMMMSSSSSSSSSSSSSSMMMMM--MMMMMM1
1EEEEEEEEEEEEHHHHHHHHHHEEEEEEEEE1EEEEEEEHHHHHHHHHEE11EMMMMMMMHFFFFFFHMMMSSSSSSSSSSSSSSMMMMM--MMMMMM1
1EEEEEEEEEEEEEEEEEEEEEEEEEEEE11111EEEEEEHFFFFFFFHEE11EMMMMMMMHFFFFFFHMMMMMMSSSSSSSSSMMMMMMM--MMMMMM1
1EEEEEEEEEEEEEEEEEEEEEEEEEE111EEE1EEEEEEHFFFFFFFHEE11EMMMMMMMHHHHHHHHMMMMMMMMMrrMMMMMMMMMM--MMMMMMM1
1EEEEEEEEEEEEEEEEEEEEEEEEE111EEEE1111EEEHHHHHHHHHEE11EMMMMMMMMMMMMMMMMMMMMMMMrrrMMMMMMMMMM--MMMMMMM1
1EEEEEEEEEEEEEEEEEEEEEEE111EEEEEEEEE111EEEEEEEMMMMM11MMMMMMMMMMMMMMMMMMMMMMMrrrrMMMMMMMMMM--MMMMMMM1
1EEEEEEEEEEEEEEEEEEEEE111EEEEEEHHHHHHE11EEEEEMMMHHHHHHHMMMMMMMMMMMMMMMMMMrrrrrMMMMMMMMMMMM--MMMMMMM1
1EEEEEEEEEEEEEEEEEEEEE11EEEEEEEHFFFFHEE11EMMMMMMHFFFFFHMMMMMMMMMMMMMMMMMrrrrMMMMMMMMTMMMMM--MMMMMMM1
1EEEEEEEEEEEEEEEEEEEE111EEEEEEEHFFFFHEEEMMMMMMMMHFFFFFHMMMMMMMMMMMMMMMrrrMMMMMMMMMMMMMMMMM--MMMMMMM1
1EEEEEEEEEHHHHHHHHE111EEEEEEEEEHHHHHHMMMMMMMMMMMHHHHHHHMMMMMMMMMMMMMrrrMMMMMMMMMMMMMMMMMMM--MMMMMMM1
1EEEEEEEEEHFFFFFFHE11EEEEEEEEEEEEEEMMMMMMMMMMMMMMMMMMMMMMMMMMMMMMMMrrrMMMMMMMMMMMMMMMMMMMM--MMMMMMM1
1EEEEEEEEEHFFFFFFHEEEEEEEEEEEEEEEEMMMMMHHHHHHHHMMMMMMMMMMMMMMMMMMrrrrMMMMMMMMMMMMMMMMM------MMMMMMM1
1EEEEEEEEEHFFFFFFFEEEEEEEEEEMMMMMMMMMMMHFFFFFFHMMMMMMMMMMMMMMMMrrrMMMMMMMMMMMMMMMM--------MMMMMMMMM1
1EEEEEEEEEHFFFFFFHEEEEEEMMMMMMMMMMMMMMMHFFFFFFHM------------BBBBBBB-------------------MM--MMMMMMMMM1
1EEEEEEEEEHHHHHHHHEEEEMMMMMMMMMMMMMMMMMHHHHHHHHM------------BBBBBBB----------------MMMMM--MMMMMMMMM1
1EEEEEEEEEEEEEEEEEEEMMMCCCCCCCCCCCCCCCCCCCCMMMMM--MMMMMMMMMMMMrrMMMMMMMMMMMMMMMMMMMMMMMM--MMMMMMMMM1
1EEEEEEEEEEEEEEEEMMMMMMCMMMMMMMMMMMMMMMMMMCMMMMMM--MMMMMMMMMMMrrMMMMMMMMMMMMMMMMMMMMMMMM--MMMMMMMMM1
1EEEEEEEEEEEEEEEMMMMMMMCMMM-------------MMCMMMMMMM--MMMMMMMMrrrMMMMMMMMMMMMMMMMMMMMMMMMM--MMMMMMMMM1
1EEEEEEEEEEEEEEEMMMMMMMCMM--MCCCCCCCCMM--MCCCCCCCC--MMMMMMMMrrrMMMMMMMMMMMMMMMMMMMMMMMMM--MMMMMMMMM1
1EEEEEEEEEEEEEEMMMMMMMMCMM--MCFFFFFFCMMM------MMMMCCCCMMMMMMrrMMMMMMMMMMMMMMMMMMMMMMMMMM--MMMTMMMMM1
1EEEEEEEEEEEEEMMMMMMMMMCMM--MCFFFFFFCMMM------------MCCCCCCCCCCCCCCCMMMMMMMMMMMMMMMMMMMM--MMMMMMMMM1
1EEEEEEEEEEEEMMMMMMMMMMCMM--MCFFFFFFCMMMMMMMMMMM----MMrrrrrMMMMMMMMCCCCCCCCCCMMMMMMMMMMM--MMMMMMMMM1
1EEEEEEEEMMMMMMMMMMMMMMCMM--MCCFFCCCCCCCCCCCCCCMMM--MMMrrMMMMMMMMMMMMMMMMMMMCMMMMMMMMMMM--MMMMMMMMM1
1MMMMMMMMMMMMMMMMMMMMMMCMM--MCFFFCFFFFFFFFFFFFCMMM--MMrrrMMMMHHHHHHHHHHMMMMMCCCCMMMMMMMM--MMMMMMMMM1
1MMMMMMMMMMMMMMMMMMMMMMCMM--MCCCCCFFFFFFFFFFFFCMMM--rrrrMMMMMHFFFFFFFFHMMMMMMMMCCMMMMMMM--MMMMMMMMM1
1MMMMMMMMMMSSSSSSSMMMMMCMM--MMMMMCFFFFFFFFFFFFCMMM--rrrMMMMMMHFFFFFFFFHMMMMMMMMMCMMMMMMM--MMMMMMMMM1
1MMMMMMMMMSSSSSSSSSSMMMCMM--MMMMMCFFFFFFFFFFFFCMM---rrrMMMMMMHFFFFFFFFHMMMMMMMMMCMMMMMMM--MMMMMMMMM1
1MMMMMMMSSSSSSSSSSSSMMMCMM--MMMMMCFFFFFFFFFFFFCM--BBBBBBBMMMMHFFFFFFFFHMMMMMMMMMCCMMMMMM--MMMMMMMMM1
1MMMMMSSSSSSSSSSSSSSMMMCM-------MCFFFFFFFFFFFFCM--BBBBBBBMM.MHFFFFFFFFHHHHHHMMMMMCMMMMMM--MMMMMMMMM1
1MMMMMSSSSSSSSSSSSSSMMMCM-------MCFFFFFFFFFFFFCMMMMMrrrMMM-MMHFFFFFFFFHFFFFHMMMMMCMMMMMM--MMMMMMMMM1
1MMMMMSSSSSSSSSSSSSMMMMCM--MMMMMMCFFFFFFFFFFFFCMMMMrrrrMM--MMHFFFFFFFFHFFFFHMMMMMCMMMMMM--MMMMMMMMM1
1MMMMMSSSSSSSSSSSSMMMMMCM--MMMMMMCFFFFFFFFFFFFCMMMrrrMMMMM-MMHFFFFFFFFHFFFFHMMMMMCMMMMMM--MMMMMMMMM1
1MMMMMMSSSSSSSSSSMMMMMMCM--MCCCCCCFFFFFFFFFFFFCMMMrrrMMMMM-MMHHHHHHHHHHHHHHHMMMMMCMMMMMM--MMMMMMMMM1
1MMMMMMMMMMMMMMMMMMMMMMCM--MCFFFFCFFFFFFFFFFFFCMMMrrMMMM-------------------------C---------MMMMMMMM1
1MMMMMMMMMDMMMMMDDDDDDDCM--MCFFFFCFFFFFFFFFFFFCMMMrrMM---------------------------C---------MMMMMMMM1
1MMMMMMMDDDDDDDDDDDDDDDCM--MCCCCCCCCCCCCCCCCCCCMMMrrM---MMM--MMMMMM-MMMMHHHHHHMMMCMMMMMMM--MMMMMMMM1
1MMMMMMDDDDDDDDDDDDDDDDCM---------------MMMMMMMMMrrrM--MMMM--MMMMMM--MMMHFFFFHMMMCMMMMMMM--MMMMMMMM1
1DDDDDDDDDDDDDDDDDDDDDDCM------------------BBBBBBBBB---MMMMMMMMMMMMM----HFFFFHMMMCCMMMMMM--MMMMMMMM1
1DDDDDDDDDDDDDDDDDDDDDDCMMMMMHHHHHHHHHH----BBBBBBBBB---HHHHHHHHHHMMMMMMMHFFFFHMMMMCMMMMMM--MMMMMMMM1
1IIIIIIIIIIDDDDDDDDDDDDCMMMMMHFFFFFFFFHMMMMMMrrrMMMM--MHFFFFFFFFHMMMMMMMHHHHHHMMMMCMMMMMM--MMMMMMMM1
1IIIIIIIIIIIIIIDDDDDDDDCMMMMMHFFFFFFFFHMMMMMrrrMMMMM--MHFFFFFFFFHMMMMMMMMMMMMMMMMMCMMMMMM--MMMMMMMM1
1IIIIIIIIIIIIIIIIIIDDDDCMMMMMHFFFFFFFFHMMMMMrrMMMM----MHFFFFFFFFHMMMMMMMMMMMMMMMMMCMMMMMM--MMMMTMMM1
1IIIIIIIIIIIIIIIIIIIDDDCMMMMMHFFFFFFFFHMMMMMrrMMMM----MHFFFFFFFFHMMMMMMMMMMMMMMMMMCMMMMM---MMMMMMMM1
1IIIIIIIIIIIIIIIIIIIIDDCMMMMMHFFFFFFFFHMMMMMrrMMMM--MMMHFFFFFFFFHHHHHHHMMMMMMMMMMMCDDDMM--MMMMMMMMM1
1IIIIIIIIIIIIIIHHHHHDDDCCMMMMHFFFFFFFFHMMMMrrrMMMM--MMMHFFFFFFFFHFFFFFHMMMMMMMMMMMCDDDDD--DDDMMMMMM1
1IIIIIIIIIIIIIIHFFFHDDDDCMMMMHFFFFFHHHHMMMrrrMMMMM--MMMHFFFFFFFFHFFFFFHMMMMMMMMCMMCDDDDDD---DDDDDDD1
1IIIIIIIIIIIIIIHFFFHIIDDCMMMMHFFFHHH000rrrrrMMMMM---MMMHFFFFFFFFHFFFFFHMMMMMMMMCMMCDDDDDDDD--DDDDDD1
1IIIIIIIITIIIIIHFFFHIIDDCMMMMHHHHH0rrrrrrrrMMMMMM--MMMMHHHHHHHHHHHHHHHHMCCCCCCCCCCCDDDHHHHHD-DDDDDD1
1IIIIIIIIIIIIIIHFFFHIIDDCMMMMMMMMMrrrMMMMMMMMMM----MMMMMMMMMMMMMMMMMMMMMCDDDDDDDDDDDDDHFFFHD--DDDDD1
1IIIIIIIIIIIIIIHHHHHIIDDCMMMMMMMrrrMMMMMMMMMMMM--MMMMMMMMMMMMMMMMMMMMMMMCDDDDDDDDDDDDDHFFFHDD-DDDDD1
1IIHHHHHIIIIIIIIIIIIIIDDCMMMMMMMrrMMMMMMMMMMHHHHHMMMMMMMCCCCCCCCCCCCCCCCCDDDDDDDDDDDDDHHHHH---DDDDD1
1IIHFFFHIIIIIIIIIIIIIDDDCCCCCCCCCCCCCCCCMMMMHFFFHMMMMMMCCDDDDDDDCCCCCCDDDDHHHHHHHHHDDDDDD---DDDDDDD1
1IIHFFFHIIIIIIIIIIIIIDDDDDDDDDDrrDDDDDCCMMMMHFFFHMMMMMMCDDDDDDDDDDDDDDDDDDHFFFFFFFHDDDDD--DDDDDDDDD1
1IIHHHHHIIIIIIIIIIIIIIIDDDDDDDDrrDDDDDCCMMMMHFFFHMMMMMCCDDDDDDDDDDDDDDDDDDHFFFFFFFHDDDD--DccccccDDD1
1IIIIIIIIIIIIIIIIHHHHHIIIIDDDDrrDDDDDDCCMMMMHHHHHMMMMMCCDDDDDDDDDDDDDDDDDDHHHHHHHHHDDD--DDcFFFFcDDD1
1IIIIIIIIIIIIIIHIIIIIFII-IIIrrrDDDDDDDCCCCCCCCCCCCCCCCCCDDDDDDDDDDDDDDDDDDDDDDDDDDDD---DDDcFFFFcDDD1
1IIIIIIIIIIIITIHIIFIIIHII-IIrrDDDDDDDDDDDDDDDDDDDDCDDDDDDDDDDDDDDDDDDDDDDDDDDDDDDDD--DDDDDcFFFFcDDD1
1IIIIIIIIIIIIIIHIIIIIIII-IIIrrDDDDDDDDDDDDDDDDDDDDDDDDDDDDDDDDDDDDDDDDDDDD---DDDDD--DDDDDDcFFFFcDDD1
1IIICCCCCIIIIIIIHIF-IIIIIIIIrrDDDDDDDDDDDDDDDDDDDDDDDDDDDDDDDDDDDDDD-------D----------DDDDccccccDDD1
1IIIIFFIIFCIIIIIIHII-IIIIIIIrrDDDDDDDDDDDDDDDDDDDDDDDDDDDDDDDTDDDTD--DDDDTDTDDDDDDDDD-DDDDDDDDDDDDD1
1IICIIFIIICCIIIIIIII-IIIIIIrrDDDDDDDDDDDDDDDDDDDDDDDDDDDDDDTDDDD----DDTDDDDDTDDDDDDDD--DDDDDDDDDDDD1
1IICIIIIFIICIIIHII-IIIIIIIIrrDDDDDDDDDDDDDDDDDDDDDDDDDDDDDDDDDD--TDDDDDDDDDDDTDDDDDDDD--DDDDDDDDDDD1
1IIIFIIIIIIIIIIHHIIIIIIIIIIrrDDDDDDDDDDDDDDDDDDDDDDDDDDDDDDDD---DDDTDDDDDDDTDDDDTDDDDDD-DDDDDDDDDDD1
1cccIIIICICIII----I-I--BBBBBBB--DDDDDDDDDDDDDDDDDDDDDDDDDDD---DDDDDDHHHHHHDDDTDDDDTDDDD-DDDDDDDDDDD1
1IIcccccIIII-I-IIIII-IIIrrrrDDD---------DDDDDDDDDDDDDDDDD---DDTDDDDDHFFFFHDDDDDTTDDDDDD---DDDDDDDDD1
1IIIIIIIccIIIIIHHHIIIIIrrDDDDDDDDDDDDDD----DDDDDDDDDD-----DDDDDDDTDDHFFFFHDTTDDDDDDDDDDDD--DDDDDDDD1
1IIIIIIIIcIIIIIIIHIIIIIrDDDDDDDDDDDDDDDDDD---DDDDD----DDDDDDTDDDDDDDHFFFFHDDDDTDDTTDDDDDDD-DDDDDDDD1
1IIIIIIIIIcccIFIIIIIIIrrrDDDDDDDDDDDDDDDDDDD-------DDDDDDDDDDDDDTDDDHHHHHHDDTDDDDDDDDDDDDDDDDDDDDDD1
1IIIIIIIIIIIccIIFIIIIIrrrDDDDDDDDDDDDDDDDDD------DDDDDDDDDDDDTDDDDDDTDDDDDDDDDDTDDTDDDDDDDDDDDDDDDD1
1IIIIIIIIIIIIcIIIIFHIIrrrDDDDDHHHHHHHDDD---DDDDDDDDDDDDDDDDDDDDDTDDDDTDDDDTDTDDDTDDDDDDDDDDDDDDDDDD1
1IIIIIIIIIIIIccIIHHHIIrDDDDDDDHFFFFFHDDDDDDDDDDDDDDDDDDDDDDDDDDDDDDDDDDTTDDDDDDDDDDDDDDDDDDDDDDDDDD1
1IIIIIIIIIIIIIcIIIIIIrrDDDDDDDHFFFFFHDDDDDDDDDDDDDDDDDDDDDDDDDDDDDDDDDDDDDDDDDDDDDDDDDDDDDDDDDDDDDD1
1IIIIIIIIIIIIIcIIIIIrrDDDDDDDDHFFFFFHDDDDDDDDDDDDDDDDDDDDDDDDDDDDDDDDDDDDDDDDDDDDDDDDDDDDDDDDDDDDDD1
1IIIIIIIIIIIIIccIIrrDDDDDDDDDDHHHHHHHDDDDDDDDDDDDDDDDDDDDDDDDDDDDDDDDDDDDDDDDDDDDDDDDDDDDDDDDDDDDDD1
1IIIIIIIIIIIIIIcrrrDDDDDDDDDDDDDDDDDDDDDDDDDDDDDDDDDDDDDDDDDDDDDDDDDDDDDDDDDDDDDDDDDDDDDDDDDDDDDDDD1
1IIIIIIIIIIIIIIcrDDDDDDDDDDDDDDDDDDDDDDDDDDDDDDDDDDDDDDDDDDDDDDDDDDDDDDDDDDDDDDDDDDDDDDDDDDDDDDDDDD1
1111111111111111111111111111111111111111111111111111111111111111111111111111111111111111111111111111