SSSSSSSSSSSSSSSSSSSSSSSSSSSSSSSSSSSSSSSSSSSSSSSSSSSSSSSSSSSSSSSSSSSSSSSSSSSSSSSSSSSSSSSSSSSSSSSSSSSSSSSSSS
SSSSSSSSSSSSSSSSSSSSSSSSSSSSSSSSSSSSSSSSSSSSSSSSSSSSSSSSSSSSSSSSSSSSSSSSSSSSSSSSSSSSSSSSSSSSSSSSSSSSSSSSSS
SSSSSSSSSSSSSSSSSSSSSSSSSSSSSSSSSSSSSSSSSSSSSSSSSSSSSSSSSSSSSSSSSSSSSSSSSSSSSSSSSSSSSSSSSSSSSSSSSSSSSSSSSS
SSSSSSSSSSSSSSSSSSSSSSSSSSSSSSSSSSSSSSSSSSSSSSSSSSSSSSSSSSSSSSSSSSSSSSSSSSSSSSSSSSSSSSSSSSSSSSSSSSSSSSSSSS
SSSSLEEEEEEEEEEEEEEEEEEEEEEEEcEEEEEEEEEEEEEEEEEEEEEEEEEEEEEEEEEEEEEEEEEEEEMMMMMMMMMMMMMMMMMMMMMMMMMrrMSSSS
SSSSEEEEEEEEEEEEEEEEEEEEEEEEEcEEEEEEEEEEEEEEEEEEEEEEEHHHHHHHHHHEEEEEEEEEEMMMMMMMMMMMMMMMMMMMMMMMrrrrMMSSSS
SSSSEEEEEEEEEEEEEEEEEEEEEEcccEEEEEEEEEEEEEEEEEEEEEEEEHFFFFFFFFHEEEEEEEEEMMMMMMMMMMMMMMMMMMMMMMrrrMMMMMSSSS
SSSSEEEEEEEEEEEEEEEEEEEEEccEEEEEEEEEEEEEEEEEEEEEEEEEEHFFFFFFFFHEEEEEEMMMMMMMMMMMMMMMMMMMMMMMMMrrMMMMMMSSSS
SSSSEEEEEEEEEEEEEEEEEEEEcEEEEEEEEEEEEEEEEEEEEEEEEEEEEHFFFFFLFFHEEEEEEMMMMMMMMMMMMMMMMMMMMMMMMrrrMMMMMMSSSS
SSSSEEEEEbEEEEEEEEEEEEEccEEEEEEEEEEEEEEEEEEEEEEEEEEEEHFFFFFFFFHEEEEEEMMMMMMMMMMMMMMMMMMMMMMrrrrMMMMMMMSSSS
SSSSEEEEEEEEEEEEEEEEEEEEEEEEEEEEEEEEEEEEEEEEEEEEEEEEEHFFFFFFFFHEEEEEEMMMMMMMMMMMMMMMMMMMMMrrMMMMMMMMMMSSSS
SSSSEEEEEEEEEEEEEEEcEEEE--EEEEEEEEEEEEEEEEEEEEEEEEEEEHFFFFFFFFHEEEEEEMMMMMMMMMMMMMMMMMMMMrrMMMMMMMMMMMSSSS
SSSSEEEEEEEEEEEEEEccEEEEE---EEEEEEEEEEEEEEEEEEEEEEEEEFFFFFFFFFHEEEEEEMMMMMMMMMMMMMMMMMMMMrrMMMMMMMMMMMSSSS
SSSSEEEEEEEEEEEEcccEEEEEEEE--EEEEEEEEEEEEEEEEEEEEE-EEFFFFFFFFFHEEEEEEMMMMMMMMMMMMMMMMMMMMrrMMMMMMMMMMMSSSS
SSSSEEEEEEEEEEEccEEEEEEEEEEE---EEEEEEEEEEEEEEEEEE--EEHFFFFFFFFHEEEEEEMMMMMMMMMMMMMMMMMMMMrrMMMMMMMMMMMSSSS
SSSSEEEEEEEEEEccEEEEEEEEEEEEEE--EEEEEEEEEEEEEEEE--EEEHHHHHHHHHHEEEEEMMMMMMMMMMMMMMMMMMMMrrrMMMMMMMMMMMSSSS
SSSSEEEEEEEEEccEEEEEEEEEEEEEEEE--EEEEEEEEEEEEEE--EEEEEEEEEEEEEEEEEEEMMMMMMMMMMMMMMMMMMMMrrMMMMMMMMMMMMSSSS
SSSSccccccccccEEEEEEEEEEEEEEEEEE--EEEEEEEEEEEE--EEEEEEEEEEEEEEEEEEEMMMMMMMMMMMMMMMMMMMrrrrMMMMMMMMMMMMSSSS
SSSSEEEEEEEEEEEEHHHHHHHHHHEEEEEE--EEEEEEEEEE---EEEEEEEEEEEEEEEEEEMMMMMMMMMM---------BBBBBBBB-----MMMMMSSSS
SSSSEEEEEEEEEEEEHFFFFFFFFHEEEEEE--EEEEEEEEE--EEEEEEEEEEEEEEEEEEEEMMMMMMMMMM---------BBBBBBBB-----MMMMMSSSS
SSSSEEEEEEEEEEEEHFFFFFFFFHEEEEEE--EEEEEEEE--EEEEEEEEEEEEEEEEEEEEMMMMMMMMMMM-MMMMMMMMMMMrMMMMMMM--MMMMMSSSS
SSSSEEEEEEEEEEEEHFFFFFFFFHEEEEEE--EEEEEEE--EEEEEEEEEEEEEEEEEEEE-------------MMRMMMMMMMMrMMMMMMM--MMMMMSSSS
SSSSEEEEEEEEEEEEHFFLFFFFFFE--------------------EEEEEEEEEEEEEEE--------------SSSSSSSSSSSSMMMMMMM--MMMMMSSSS
SSSSEEEEEEEEEEEEHFFFFFFFFFE-------------------------------------MMMMMMMMMMMSSSSSSSSSSSSSSMMMMMM--MMMMMSSSS
SSSSEEEEEEEEEEEEHFFFFFFFFHEEEEEEE-EEEEEEEEEEEEE---------------MMHHHFFHHHMMRSSSSSSSSSSSSSSMMMMMM--MMMMMSSSS
SSSSEEEEEEEEEEEEHFFFFFFFFHEEEEEEE--EEEEEEEEEEEEEEEEEEE--EEMMMMMMHLFFFFFHMMRSSSSSSSSSSSSSSMMMMMM--MMMMMSSSS
SSSSEEEEEEEEEEEEHFFFFFFFFHEEEEEEEE--EEEEEEEEEEEEEEEEEE--EMMMMMMMHFFFFFFHMMMSSSSSSSSSSSSSSMMMMM--MMMMMMSSSS
SSSSEEEEEEEEEEEEHHHHHHHHHHEEEEEEEEE-EEEEEEEHHHHHHHHHEE--EMMMMMMMHFFFFFFHMMMSSSSSSSSSSSSSSMMMMM--MMMMMMSSSS
SSSSEEEEEEEEEEEEEEEEEEEEEEEEEEEE-----EEEEEEHFFFFFFFF----EMMMMMMMHFFFFFFHMMMMMMSSSSSSSSSMMMMMMM--MMMMMMSSSS
SSSSEEEEEEEEEEEEEEEEEEEEEEEEEE---EEE-EEEEEEHFFFFFFFF----EMMMMMMMHHHHHHHHMMMMMMMMMrrMMMMMMMMMM--MMMMMMMSSSS
SSSSEEEEEEEEEEEEEEEEEEEEEEEEE---EEEE----EEEHHHHHHHHHEE--EMMMMMMMMMMMMMMMMMMMMMMMrrrMMMMMMMMMM--MMMMMMMSSSS
SSSSEEEEEEEEEEEEEEEEEEEEEEE---EEEEEEEEE---EEEEEEEMMMMM--MMMMMMMMMMMMMMMMMMMMMMMrrrrMMMMMMMMMM--MMMMMMMSSSS
SSSSEEEEEEEEEEEEEEEEEEEEE---EEEEEEHHHHHHE--EEEEEMMMHHHHHHHMMMMMMMTMMMMMMMMMMrrrrrMMMMMMMMMMMM--MMMMMMMSSSS
SSSSEEEEEEEEEEEEEEEEEEEEE--EEEEEEEHFFFFHEE--EMMMMMMHFFFFFHMMMMMMMMMMMMMMMMMrrrrMMMMMMMMTMMMMM--MMMMMMMSSSS
SSSSEEEEEEEEEEEEEEEEEEEE---EEEEEEEHFFFFHEEEMMMMMMMMHFFFFFHMMMMMMTMMMMMMMMrrrMMMMMMMMMMMMMMMMM--MMMMMMMSSSS
SSSSEEEEEEEEEHHHHHHHHE---EEEEEEEEEHHHHHHMMMMMMMMMMMHHHHHHHMMMMMTMMMMMMMrrrMMMMMMMMMMMMMMMMMMM--MMMMTMMSSSS
SSSSEEEEEEEEEHFFFFFFHE--EEEEEEEEEEEEEEMMMMMMMMMMMMMMMMMMMMMMMMMMMMMMMMrrrMMMMMMMMTMMMMMMMMMMM--MMMMMMMSSSS
SSSSEEEEEEEEEHFFFFFFHEEEEEEEEEEEEEEEEMMMMMHHHHHHHHMMTMMMMMMMMMMMMMMMrrrrMMMMMMMMMMMMMMMMM------MMMMMMMSSSS
SSSSEEEEEEEEEHFFFFFFFEEEEEEEEEEMMMMMTMMMMMHFFFFFFHMMMMMMMMMMMMMMMMrrrMMMMMMMMMMMMMMMM--------MMMMMMMMMSSSS
SSSSEEEEEEEEEHFFFFFFHEEEEEEMMMMMMMMMMMMMMMHFFFFFFHM------------BBBBBBB-------------------MM--MMMMMMMMMSSSS
SSSSEEEEEEEEEHHHHHHHHEEEEMMMMMMMMMMMMMMMMMHHHHHHHHM------------BBBBBBB----------------MMMMM--MMMMMMMMMSSSS
SSSSEEEEEEEEEEEEEEEEEEEMMMCCCCCCCCCCCCCCCCCCCCMMMMM--MMMMMMMMMMMMrrMMMMMMMMMMMMMMMMMMMMMMMM--MMMMMMMMMSSSS
SSSSEEEEEEEEEEEEEEEEMMMMMMCYYYYYYYYYYYYYYYYYYCMMMMMM--MMMMMMMMMMMrrMMMMMMMMMMMMMMMMMMMMMMMM--MMMMMMMMMSSSS
SSSSEEEEEEEEEEEEEEEMMMMMMMCYYY-------------YYCMMMMMMM--MMMMMMMMrrrMMMMMMMMMMMMMMMMMMMMMMMMM--MMMMMMMMMSSSS
SSSSEEEEEEEEEEEEEEEMMMMMMMCYY--YCCCCCCCCYY--YCCCCCCCC--MMMMMMMMrrrMMMMMMMMMMMMMMMMMMMMMMMMM--MMMMMMMMMSSSS
SSSSEEEEEEEEEEEEEEMMMMMMMMCYY--YCFFFFFFCYYY------MMMMCCCCMMMMMMrrMMMMMMMMMMMMMMMMMMMMMMMMMM--MMMTMMMMMSSSS
SSSSEEEEEEEEEEEEEMMMTMMMMMCYY--YCFFFFFFCYYY------------MCCCCCCCCCCCCCCCMMMMMMMMMMMMMMMMMMMM--MMMMMMMMMSSSS
SSSSEEEEEEEEEEEEMMMMMMMMMMCYY--YCFFFFFFCYYYYYYYYYYY----MMrrrrrYYYYYYYYCCCCCCCCCCMMMMMMMMMMM--MMMMMMMMMSSSS
SSSSEEEEEEEEMMMMMMMMMMMMMMCYY--YCCFFCCCCCCCCCCCCCCYYY--MMMrrYYYYYYYYYYYYYYYYYYYCMMMMMMMMMMM--MMMMMMMMMSSSS
SSSSMMMMMMMMMMMMMMMMMMMMMMCYY--YCFFFCFFFFFFFFFFFFCYYY--MMrrrYYYYHHHHHHHHHHYYYYYCCCCMMMMMMMM--MMMTMMMMMSSSS
SSSSMMMMMMMMMMMMMMMMMMMMMMCYY--YCCFCCFFFFFFFFFFFFCYYY--rrrrYYYYYHFFFFFFFFHYYYYYYYYCCMMMMMMM--MMMMMMMMMSSSS
SSSSMMMMMMMMMMSSSSSSSMMMMMCYY--YYYYYCFFFFFFFFFFFFCYYY--rrrYYYYYYHFFFFFFFFHYYYYTYYYYCMMMMMMM--MMMMMMMMMSSSS
SSSSMMMMTMMMMSSSSSSSSSSMMMCYY--YYYYYCFFFFFFFFFFFFCYY---rrrYYYYYYHFFFFFFFFHYYYYYYYYYCMMMMMMM--MMMMMMMMMSSSS
SSSSMMMMMMMSSSSSSSSSSSSMMMCYY--YYYYYCFFFFFFFFFFFFFY--BBBBBBBYYYYHFFFFFFFFHYYYYYYYYYCCMMMMMM--MMMMMMMMMSSSS
SSSSMMMMMSSSSSSSSSSSSSSMMMCY-------YCFFFFFFFFFFFFFY--BBBBBBBYYYYFFFFFFFFFHHHHHHYYYYYCMMMMMM--MMMMMMTMMSSSS
SSSSMMMMMSSSSSSSSSSSSSSMMMCY-------YCFFFFFFFFFFFFCYYYYYrrrYYY-YYFFFFFFFFFHLFFFHYYYYYCMMMMMM--MMMMMMMMMSSSS
SSSSMMMMMSSSSSSSSSSSSSMMMMCY--YYYYYYCFFFFFFFFFFFFCYYYYrrrrYY--YYHFFFFFFFFFFFFFHYYTYYCMMMMMM--MMMMMMMMMSSSS
SSSSMMMMMSSSSSSSSSSSSMMMMMCY--YYYYYYCFFFFFFFFFFFFCYYYrrrYYYYY-YYHFFFFFFFFHFFFFHYYYYYCMMMMMM--MMMMTMMMMSSSS
SSSSMMMMMMSSSSSSSSSSMMMMMMCY--YCCCCCCFFFFFFFFFFFFCYYYrrrYYYYY-YYHHHHHHHHHHHHHHHYYYYYCMMMMMM--MMMMMMMMMSSSS
SSSSMMMMMMMMMMMMMMMMMMMMMMCY--YCFLFFFFFFFFFFFFFFFCYYYrrYYYY-------------------------C---------MMMMMMMMSSSS
SSSSMMMMMMMMMDMMTMMDDDDDDDCY--YCFFFFCFFFFFFFFFFFFCYYYrrYY---------------------------C---------MMMMMMMMSSSS
SSSSMMMMMMMDDDDDDDDDDDDDDDCY--YCCCCCCCCCCCCCCCCCCCYYYrrY---YYY--YYYYYY-MMMMHHHHHHYYYCMMMMMMM--MMMMTMMMSSSS
SSSSMMMMMMDDDDDDDDDDDDDDDDCY---------------YYYYYYYYYrrrY--YYYY--YYYYYY--MMMHFFFFHYYYCMMMMMMM--MMMMMMMMSSSS
SSSSDDDDDDDDDDDDDDDDDDDDDDCY------------------BBBBBBBBB---YYYYYYYYYYYYY----HFFFFHYYYCCMMMMMM--MMMMMMMMSSSS
SSSSDDDDDDDDDDDDDDDDDDDDDDCYYYYYHHHHHHHHHH----BBBBBBBBB---HHHHHHHHHHYYYYYYYHFFFFHYYYYCMMMMMM--MMMMMMMMSSSS
SSSSIIIIIIIIIIDDDDDDDDDDDDCYYYYYHFFFFFFFFHYYYYYYrrrYYYY--YHFFFFFFFFHYYYYYYYHHHHHHYYYYCMMMMMM--MMMMMMMMSSSS
SSSSIIIIIIIIIIIIIIDDDDDDDDCYYYYYHFFFFFFFFHYYYYYrrrYYYYY--YHFFFFFFFFHYYYYTYYYYYYYYYYTYCMMMMMM--MMMMMMMMSSSS
SSSSIIIIIIIIIIIIIIIIIIDDDDCYYYYYHFFFFFFFFHYYYYYrrYYYY----YFFFFFFFFFHYYYYYYYYYYYYYYYYYCMMMMMM--MMMMTMMMSSSS
SSSSIIIIIIIIIIIIIIIIIIIDDDCYYYYYHFFFFFFFFFYYYYYrrYYYY----YFFFFFFFFFHYYYYYYYYYYYYYYYYYCMMMMM---MMMMMMMMSSSS
SSSSIIITIIIIIIIIIIIIIIIIDDCYYYYYHFFFFFFFFFYYYYYrrYYYY--YYYHFFFLFFFFHHHHHHHYYYTYYYYYYYCDDDMM--MMMMMMMMMSSSS
SSSSIIIIIIIIIIIIIIHHFHHDDDCCYYYYHFFFFFFFFHYYYYrrrYYYY--YYYHFFFFFFFFHFFFFFHYYYYYYYYYYYCDDDDD--DDDMMMMMMSSSS
SSSSIIIIIITIIIIIIIHFFFHDDDDCYYYYHFFFFFHHHHYYYrrrYYYYY--YYYHFFFFFFFFFFFFFFHYYYYYYYYCYYCDDDDDD---DDDDDDDSSSS
SSSSIIIIIIIIIIIIIIHFFFHIIDDCYYYYHFFFHHHYYYrrrrrYYYYY---YYYHFFFFFFFFHFFFFFHYYYYYYYYCYYCDDDDDDDD--DDDDDDSSSS
SSSSIIIIIIIITIIIIIHFFFHIIDDCYYYYHHHHHYrrrrrrrrYYYYYY--YYYYHHHHHHHHHHHHHHHHYCCCCCCCCCCCDDDHHHHHD-DDDDDDSSSS
SSSSIIIIIIIIIIIIIIHFFFHIIDDCYYYYYYYYYrrrYYYYYYYYYY----YYYYYYYYYYYYYYYYYYYYYCDDDDDDTDDDDDDHFFFHD--DDDDDSSSS
SSSSIIIIIIIIIIIIIIHHHHHIIDDCYYYYYYYrrrYYYYYYYYYYYY--YYYYYYYYYYTYYYYYYYYYYYYCDDDDDDDDDDDDDHFFFHDD-DDDDDSSSS
SSSSIIHHFHHIIIIIIIIIIIIIIDDCYYYYYYYrrYYYYYYYYYYHHHHHYYYYYYYCCCCCCCCCCCCCCCCCDDDDDDDDDDDDDHHHHH---DDDDDSSSS
SSSSIIHFFFHIIIIIITIIIIIIDDDCCCCCCCCCCCCCCCCYYYYHFFFHYYYYYYCCDDDDDDDCCCCCCDDDDHHHHHHHHHDDDDDD---DDDDDDDSSSS
SSSSIIHFLFHIIIITIIIIIIIIDDTDDDDDDDrrDDDDDCCYYYYHFFFHYYYTYYCDDDDDDDDDDDDDDDDDDHFFFFFFFHDDDDD--DDDDDDDDDSSSS
SSSSIIHHHHHIIIIIIIIIIIIIIIDDDDDDDDrrDDDDDCCYTYYHFFFHYYYYYCCDDDDDDDDDDDDDDDDDDHFFFFFFFHDDDD--DccccccDDDSSSS
SSSSIIIIIIIIIIIIIIIIHHHHHIIIIDDDDrrDDDDDDCCYYYYHHHHHYYYYYCCDDDDDDDDTDDDDDDDDDHHHHHHHHHDDD--DDcFFFFcDDDSSSS
SSSSIIIITIIIITIIIIHIIIIIFII-IIIrrrDDDDDDDCCCCCCCCCCCCCCCCCCDDDDDDDDDDDDDDDDDDDDDDDDDDDD---DDDcFFFFcDDDSSSS
SSSSIIIIIIIIIIIITIHIIFIIIHII-IIrrDDDDDDDDDDDDDDDDDDDDCDDDDDDDDDDDDDDDDDDDDDDDDDDDDDDDD--DDDDDcFFFFcDDDSSSS
SSSSIIIIIIIIIIIIIIHIIIIIIII-IIIrrDDDDDDDDDDDDDDDDDDDDTDDDDDTDDDDDDDDDDDDDDDDD---DDDDD--DDDDDDcFFFFcDDDSSSS
SSSSIIICCCCCIITIIIIHIF-IIIIIIIIrrDDDDDDDDDDDDDDTTDDDDDTDDDDDDDDDDDDDDDD-------D----------DDDDccccccDDDSSSS
SSSSIIIIFFIIFCIIIIIIHII-IIIIIIIrrDDDDDDDDDDDDDDDDDDDDDTDDDTDDDDDTDDDTD--DDDDTDTDDDDDDDDD-DDDDDDDDDDDDDSSSS
SSSSIICIIFIIICCIIIIIIII-IIIIIIrrDDDDDDDDDDDDDDDDDDDLDDDDDDDDDDTDDDD----DDTDDDDDTDDDDDDDD--DDDDDDDDDDDDSSSS
SSSSIICIIIIFIICIIIHII-IIIIIIIIrrDDDDDDDDDDDDDDDTDDDDDDDDDDDDDDDDDD--TDDDDDDDDDDDTDDDDDDDD--DDDDDDDDDDDSSSS
SSSSIIIFIIIIIIIIIIHHIIIIIIIIIIrrDDDDDDDDDDDDDDDDDDDDDDDDDDDDDDDD---DDDTDDDDDDDTDDDDTDDDDDD-DDDDDDDDDTDSSSS
SSSScccIIIICICIII----I-I--BBBBBBB--DDDDDDDDDDDDDDDDDDDDDDDDDDD---DDDDDDHHHFHHDDDTDDDDTDDDD-DDDDDDDDDDDSSSS
SSSSIIcccccIIII-I-IIIII-IIIrrrrDDD---------DDDDDDDDDDDDDDDDD---DDTDDDDDHLFFFHDDDDDTTDDDDDD---DDDDDDDDDSSSS
SSSSIIIIIIIccIIIIIHHHIIIIIrrDDDDDDDDDDDDDD----DDDDDDDDDD-----DDDDDDDTDDHFFFFHDTTDDDDDDDDDDDD--DDDDDDDDSSSS
SSSSIIIIIIIIIIIIIIIIHIIIIIrDDDDDDDDDDDDDDDDDD---DDDDD----DDDDDDTDDDDDDDHFFFFHDDDDTDDTTDDDDDDD-DDDDDDDDSSSS
SSSSIIIIIIIIIIccIFIIIIIIIrrrDDDDDDDDDDDDDDDDDDD-------DDDDDDDDDDDDDTDDDHHHHHHDDTDDDDDDDDDDDDDDDDDDDDDDSSSS
SSSSIIIIIIIIIIIccIIFIIIIIrrrDDDDDDDDDDDDDDDDDD------DDDDDDDDDDDDTDDDDDDTDDDDDDDDDDTDDTDDDDDDDDDDDDDDDDSSSS
SSSSIIIIIIIIIIIIcIIIIFHIIrrrDDDDDHHHFHHHDDD---DDDDDDDDDDDDDDDDDDDDDTDDDDTDDDDTDTDDDTDDDDDDDDDDDDDDDDDDSSSS
SSSSIIIIIBIIIIIIccIIHHHIIrDDDDDDDHFFFFFHDDDDDDDDDDDDDDDDDDDDDDDDDDDDDDDDDDTTDDDDDDDDDDDDDDDDDDDDDDDDDDSSSS
SSSSIIIIIIIIIIIIIcIIIIIIrrDDDDDDDHFFFFFHDDDDDDDDDDDDDDDDDDDDDDDDDDDDDDDDDDDDDDDDDDDDDDDDDDDDDTDDDDDDDDSSSS
SSSSIIIIIIIIIIIIIcIIIIIrrDDDDDDDDHFFFFFHDDDDDDTDDDDDDDDDDDDDDTDDDDDDDDDDDDDDDDDDDDDDDDDDDDDDDDDDDDDDDDSSSS
SSSSIIIIIIIIIIIIIccIIrrDDDDDDDDDDHHHHHHHDDDDDDDDDDDDDDDDDDDTDDDDDDDDDDDDDDDDDDDDDDDDDDDDDDDTDDDDDDDDDDSSSS
SSSSIIIIIIIIIIIIIIcrrrDDDDDDDDDDDDDDDDDDDDDDDDDDDDDDDDDDDDDDDDDDDDDDDDDDDDDDDDDDDDDDDDDDDDDDDDDDDDDDDDSSSS
SSSSLIIIIIIIIIIIIIcrDDDDDDDDDDDDDDDDDDDDDDDDDDDDDDDDDDDDDDDDDDDDDDDDDDDDDDDDDDDDDDDDDDDDDDDDDDDDDDDDDDSSSS
SSSSSSSSSSSSSSSSSSSSSSSSSSSSSSSSSSSSSSSSSSSSSSSSSSSSSSSSSSSSSSSSSSSSSSSSSSSSSSSSSSSSSSSSSSSSSSSSSSSSSSSSSS
SSSSSSSSSSSSSSSSSSSSSSSSSSSSSSSSSSSSSSSSSSSSSSSSSSSSSSSSSSSSSSSSSSSSSSSSSSSSSSSSSSSSSSSSSSSSSSSSSSSSSSSSSS
SSSSSSSSSSSSSSSSSSSSSSSSSSSSSSSSSSSSSSSSSSSSSSSSSSSSSSSSSSSSSSSSSSSSSSSSSSSSSSSSSSSSSSSSSSSSSSSSSSSSSSSSSS
SSSSSSSSSSSSSSSSSSSSSSSSSSSSSSSSSSSSSSSSSSSSSSSSSSSSSSSSSSSSSSSSSSSSSSSSSSSSSSSSSSSSSSSSSSSSSSSSSSSSSSSSSS