SSSSSSSSSSSSSSSSSSSSSSSSSSSSSSSSSSSSSSSSSSSSSSSSSSSSSSSSSSSSSSSSSSSSSSSSSSSSSSSSSSSSSSSSSSSSSSSSSSSSSSSSSS
SSSSSSSSSSSSSSSSSSSSSSSSSSSSSSSSSSSSSSSSSSSSSSSSSSSSSSSSSSSSSSSSSSSSSSSSSSSSSSSSSSSSSSSSSSSSSSSSSSSSSSSSSS
SSSSSSSSSSSSSSSSSSSSSSSSSSSSSSSSSSSSSSSSSSSSSSSSSSSSSSSSSSSSSSSSSSSSSSSSSSSSSSSSSSSSSSSSSSSSSSSSSSSSSSSSSS
SSSSSSSSSSSSSSSSSSSSSSSSSSSSSSSSSSSSSSSSSSSSSSSSSSSSSSSSSSSSSSSSSSSSSSSSSSSSSSSSSSSSSSSSSSSSSSSSSSSSSSSSSS
SSSSLEEEEEEEEEEEEEEEEEEEEEEEEcEEEEEEEEEEEEEEEEEEEEEEEEEEEEEEEEEEEEEEEEEEEEMMMMMTMMMMMTMMMMMMMMMMMMMrrMSSSS
SSSSEEEEEEEEEEEEEEEEEEEEEEEEEcEEEEEEEEEEEEEEEEEEEEEEEHHHHHHHHHHEEEEEEEEEEMMMMMMMMMMMMMMMMMMMMMMMrrrrMMSSSS
SSSSEEEEEEEEEEEEEEEEEEEEEEcccEEEEEEEEEEEEEEEEEEEEEEEEHFFFFFFFFHEEEEEEEEEMMMMMMTMMMMMMMTMMMMMMMrrrMMMMMSSSS
SSSSEEEEEEEEEEEEEEEEEEEEEccEEEEEEEEEEEEEEEEEEEEEEEEEEHFFFFFFFFHEEEEEEMMMMMMMMMMMMMxMMMMMMMMMMMrrMMMMMMSSSS
SSSSEEEEEEEEEEEEEEEEEEEEcEEEEEEEEEEEEEEEEEEEEEEEEEEEEHFFFFFLFFHEEEEEEMMMMMMMMMTMMMMMMMTMMMMMMrrrMMMMMMSSSS
SSSSEEEEEEEEEEEEEEEEEEEccEEEEEEEEEEEEEEEEEEEEEEEEEEEEHFFFFFFFFHEEEEEEMMMMMMMMMMMMMMMMMMMMMMrrrrMMMMMMMSSSS
SSSSEEEEEEEEEEEEEEEEEEEEEEEEEEEEEEEEEEEEEEEEEEEEEEEEEHFFFFFFFFHEEEEEEMMMMMMMMMMTMMMMMTMMMMrrMMMMMMMMMMSSSS
SSSSEEEEEEEEEEEEEEEcEEEE--EEEEEEEEEEEEEEEEEEEEEEEEEEEHFFFFFFFFHEEEEEEMMMMMMMMMMMMTMTMMMMMrrMMMMMMMMMMMSSSS
SSSSEEEEEEEEEEEEEEccEEEEE---EEEEEEEEEEEEEEEEEEEEEEEEEFFFFFFFFFHEEEEEEMMMMMMMMMMMMMMMMMMMMrrMMMMMMMMMMMSSSS
SSSSEEEEEEEEEEEEcccEEEEEEEE--EEEEEEEEEEEEEEEEEEEEE-EEFFFFFFFFFHEEEEEEMMMMMMMMMMMMMMMMMMMMrrMMMMMMMMMMMSSSS
SSSSEEEEEEEEEEEccEEEEEEEEEEE---EEEEEEEEEEEEEEEEEE--EEHFFFFFFFFHEEEEEEMMMMMMMMMMMMMMMMMMMMrrMMMMMMMMMMMSSSS
SSSSEEEEEEEEEEccEEEEEEEEEEEEEE--EEEEEEEEEEEEEEEE--EEEHHHHHHHHHHEEEEEMMMMMMMMMMMMMMMMMMMMrrrMMMMMMMMMMMSSSS
SSSSEEEEEEEEEccEEEEEEEEEEEEEEEE--EEEEEEEEEEEEEE--EEEEEEEEEEEEEEEEEEEMMMMMMMMMMMMMMMMMMMMrrMMMMMMMMMMMMSSSS
SSSSccccccccccEEEEEEEEEEEEEEEEEE--EEEEEEEEEEEE--EEEEEEEEEEEEEEEEEEEMMMMMMMMMMMMMMMMMMMrrrrMMMMMMMMMMMMSSSS
SSSSEEEEEEEEEEEEHHHHHHHHHHEEEEEE--EEEEEEEEEE---EEEEEEEEEEEEEEEEEEMMMMMMMMMM---------BBBBBBBB-----MMMMMSSSS
SSSSEEEEEEEEEEEEHFFFFFFFFHEEEEEE--EEEEEEEEE--EEEEEEEEEEEEEEEEEEEEMMMMMMMMMM---------BBBBBBBB-----MMMMMSSSS
SSSSEEEEEEEEEEEEHFFFFFFFFHEEEEEE--EEEEEEEE--EEEEEEEEEEEEEEEEEEEEMMMMMMMMMMM-MMMMMMMMMMMrMMMMMMM--MMMMMSSSS
SSSSEEEEETEEEEEEHFFFFFFFFHEEEEEE--EEEEEEE--EEEEEEEEEEEEEEEEEEEE-------------MMRMMMMMMMMrMMMMMMM--MMMMMSSSS
SSSSEEEEEEEEEEEEHFFFFFFFFFE--------------------EEEEEEEEEEEEEEE--------------SSSSSSSSSSSSMMMMMMM--MMMMMSSSS
SSSSEEEEEEEEEEEEHFFFFFFFFFE-------------------------------------MMMMMMMMMMMSSSSSSSSSSSSSSMMMMMM--MMMMMSSSS
SSSSEEEEEEEEEEEEHFFFFFFFFHEEEEEEE-EEEEEEEEEEEEE---------------MMHHHFFHHHMMRSSSSSSSSSSSSSSMMMMMM--MMMMMSSSS
SSSSEEEEEEEEEEEEHFFFFFFFFHEEEEEEE--EEEEEEEEEEEEEEEEEEE--EEMMMMMMHLFFFFFHMMRSSSSSSSSSSSSSSMMMMMM--MMMMMSSSS
SSSSETETEEEEETEEHFFFFFFFFHEEEEEEEE--EEEEEEEEEEEEEEEEEE--EMMMMMMMHFFFFFFHMMMSSSSSSSSSSSSSSMMMMM--MMMMMMSSSS
SSSSEEEEEEEEEEEEHHHHHHHHHHEEEEEEEEE-EEEEEEEHHHHHHHHHEE--EMMMMMMMHFFFFFFHMMMSSSSSSSSSSSSSSMMMMM--MMMMMMSSSS
SSSSEEEEEEEEEEEEEEEEEEEEEEEEEEEE-----EEEEEEHFFFFFFFHEE--EMMMMMMMHFFFFFFHMMMMMMSSSSSSSSSMMMMMMM--MMMMMMSSSS
SSSSEETEEEETEEEEEEEETEEEEEEEEE---EEE-EEEEEEHFFFFFFFHEE--EMMMMMMMHHHHHHHHMMMMMMMMMrrMMMMMMMMMM--MMMMMMMSSSS
SSSSEEEEEEEEEEEEEETEEEEEEEEEE---EEEE----EEEHHHHHHHHHEE--EMMMMMMMMMMMMMMMMMMMMMMMrrrMMMMMMMMMM--MMMMMMMSSSS
SSSSETEEEEEEEEEEEEEEEEEEEEE---EEEEEEEEE---EEEEEEEMMMMM--MMMMMMMMMMMMMMMMMMMMMMMrrrrMMMMMMMMMM--MMMMMMMSSSS
SSSSTEEEETEEETEEEEEEEEEEE---EEEEEEHHHHHHE--EEEEEMMMHHHHHHHMMMMMMMTMMMMMMMMMMrrrrrMMMMMMMMMMMM--MMMMMMMSSSS
SSSSEEEEEEEEEEEEEEEEEEEEE--EEEEEEEHFFFFHEE--EMMMMMMHFFFFFHMMMMMMMMMMMMMMMMMrrrrMMMMMMMMTMMMMM--MMMMMMMSSSS
SSSSEEEEEEEEEEEEEEEEEEEE---EEEEEEEHFFFFHEEEMMMMMMMMHFFFFFHMMMMMMTMMMMMMMMrrrMMMMMMMMMMMMMMMMM--MMMMMMMSSSS
SSSSETEEEEEEEHHHHHHHHE---EEEEEEEEEHHHHHHMMMMMMMMMMMHHHHHHHMMMMMTMMMMMMMrrrMMMMMMMMMMMMMMMMMMM--MMMMTMMSSSS
SSSSEEEEEEEEEHFFFFFFHE--EEEEEEEEEEEEEEMMMMMMMMMMMMMMMMMMMMMMMMMMMMMMMMrrrMMMMMMMMTMMMMMMMMMMM--MMMMMMMSSSS
SSSSTEEEEEEEEHFFFFFFHEEEEEEEEEEEEEEEEMMMMMHHHHHHHHMMTMMMMMMMMMMMMMMMrrrrMMMMMMMMMMMMMMMMM------MMMMMMMSSSS
SSSSEEEETEEEEHFFFFFFFEEEEEEEEEEMMMMMTMMMMMHFFFFFFHMMMMMMMMMMMMMMMMrrrMMMMMMMMMMMMMMMM--------MMMMMMMMMSSSS
SSSSEEEEEEEEEHFFFFFFHEEEEEEMMMMMMMMMMMMMMMHFFFFFFHM------------BBBBBBB-------------------MM--MMMMMMMTMSSSS
SSSSEEEEEEEEEHHHHHHHHEEEEMMMMMMMMMMMMMMMMMHHHHHHHHM------------BBBBBBB----------------MMMMM--MMMMMMMMMSSSS
SSSSETEEEEEEEEEEEEEEEEEMMMCCCCCCCCCCCCCCCCCCCCMMMMM--MMMMMMMMMMMMrrMMMMMMMMMMMMMMMMMMMMMMMM--MMMMMMMMMSSSS
SSSSEEETEEEEEEEEEEEEMMMMMMCYYYYYYYYYYYYYYYYYYCMMMMMM--MMMMMMMMMMMrrMMMMMMMMMMMMMMMMMMMMMMMM--MMMMMMMMMSSSS
SSSSEEEEEETEEEEEEEEMMMMMMMCYYY-------------YYCMMMMMMM--MMMMMMMMrrrMMMMMMMMMMMMMMMMMMMMMMMMM--MMMMMMMMMSSSS
SSSSEEEEEEEEEETEEEEMMMMMMMCYY--YCCCCCCCCYY--YCCCCCCCC--MMMMMMMMrrrMMMMMMMMMMMMMMMMMMMMMMMMM--MMMMMMMMMSSSS
SSSSEEEEEEEEEEEEEEMMMMMMMMCYY--YCFFFFFFCYYY------MMMMCCCCMMMMMMrrMMMMMMMMMMMMMMMMMTMMMMMMMM--MMMTMMMMMSSSS
SSSSETEEEEEEEEEEEMMMTMMMMMCYY--YCFFFFFFCYYY------------MCCCCCCCCCCCCCCCMMMMMMMMMMMMMMMMMMMM--MMMMMMMMMSSSS
SSSSEEEEEEEEEEEEMMMMMMMMMMCYY--YCFFFFFFCYYYYYYYYYYY----MMrrrrrYYYYYYYYCCCCCCCCCCMMMMMMMMMMM--MMMMMMMMMSSSS
SSSSEEEEEEEEMMMMMMMMMMMMMMCYY--YCCFFCCCCCCCCCCCCCCYYY--MMMrrYYYYYYYYYYYYYYYYYYYCMMMMMMMMMMM--MMMMMMMMMSSSS
SSSSMMMMMMMMMMMMTMMMTMMMMMCYY--YCFFFCFFFFFFFFFFFFCYYY--MMrrrYYYYHHHHHHHHHHYYYYYCCCCMMMMMMMM--MMMTMMMMMSSSS
SSSSMMMMMMMMMMMMMMMMMMMMMMCYY--YCCFCCFFFFFFFFFFFFCYYY--rrrrYYYYYHFFFFFFFFHYYYYYYYYCCMMMMMMM--MMMMMMMMMSSSS
SSSSMMMMMMMMMMSSSSSSSMMMMMCYY--YYYYYCFFFFFFFFFFFFCYYY--rrrYYYYYYHFFFFFFFFHYYYYTYYYYCMMMMMMM--MMMMMMMMMSSSS
SSSSMMMMTMMMMSSSSSSSSSSMMMCYY--YYYYYCFFFFFFFFFFFFCYY---rrrYYYYYYHFFFFFFFFHYYYYYYYYYCMMMMMMM--MMMMMMMMMSSSS
SSSSMMMMMMMSSSSSSSSSSSSMMMCYY--YYYYYCFFFFFFFFFFFFFY--BBBBBBBYYYYHFFFFFFFFHYYYYYYYYYCCMMMMMM--MMMMMMMMMSSSS
SSSSMMMMMSSSSSSSTSSSSSSMMMCY-------YCFFFFFFFFFFFFFY--BBBBBBBYYYYFFFFFFFFFHHHHHHYYYYYCMMMMMM--MMMMMMTMMSSSS
SSSSMMMMMSSSSSSSSSSSSSSMMMCY-------YCFFFFFFFFFFFFCYYYYYrrrYYY-YYFFFFFFFFFHLFFFHYYYYYCMMMMMM--MMMMMMMMMSSSS
SSSSMMMMMSSSSSSSSSSSSSMMMMCY--YYYYYYCFFFFFFFFFFFFCYYYYrrrrYY--YYHFFFFFFFFFFFFFHYYTYYCMMMMMM--MMMMMMMMMSSSS
SSSSMMMMMSSSSSSSSSSSSMMMTMCY--YYYYYYCFFFFFFFFFFFFCYYYrrrYYYYY-YYHFFFFFFFFHFFFFHYYYYYCMMMMMM--MMMMTMMMMSSSS
SSSSMMTMMMSSSSSSSSSSMMMMMMCY--YCCCCCCFFFFFFFFFFFFCYYYrrrYYYYY-YYHHHHHHHHHHHHHHHYYYYYCMMMMMM--MMMMMMMMMSSSS
SSSSMMMMMMMMMMMMMMMMMMMMMMCY--YCFLFFFFFFFFFFFFFFFCYYYrrYYYY-----------------------------------MMMMMMMMSSSS
SSSSMMMMMMMMMDMMTMMDDDDDDDCY--YCFFFFCFFFFFFFFFFFFCYYYrrYY-------------------------------------MMMMMMMMSSSS
SSSSMMMMMMMDDDDDDDDDDDDDDDCY--YCCCCCCCCCCCCCCCCCCCYYYrrY---YYY--YYYYYY-MMMMHHHHHHYYYCMMMMMMM--MMMMTMMMSSSS
SSSSMMMMMMDTDDDDDDDDTDDDDDCY---------------YYYYYYYYYrrrY--YYYY--YYYYYY--MMMHFFFFHYYYCMMMMMMM--MMMMMMMMSSSS
SSSSDDDDDDDDDDDDDDDDDDDDDDCY------------------BBBBBBBBB---YYYYYYYYYYYYY----FFFFFHYYYCCMMMMMM--MMMMMMMMSSSS
SSSSDDDDDDDDDDDDDDTDDDDDDDCYYYYYHHHHHHHHHH----BBBBBBBBB---HHHHHHHHHHYYYYYYYHFFFFHYYYYCMMMMMM--MMMMMMMMSSSS
SSSSIIIIIIIIIIDDDDDDDDDDDDCYYYYYHFFFFFFFFHYYYYYYrrrYYYY--YHFFFFFFFFHYYYYYYYHHHHHHYYYYCMMMMMM--MMMMMMMMSSSS
SSSSIIIIIIIIIIIIIIDDDDDDDDCYYYYYHFFFFFFFFHYYYYYrrrYYYYY--YHFFFFFFFFHYYYYTY YYYYYYYYTYCMMMMMM--MMMMMMMMSSSS
SSSSIIIIIITIIIIIIIIIIIDDDDCYYYYYHFFFFFFFFHYYYYYrrYYYY----YFFFFFFFFFHYYYYYYYYYYYYYYYYYCMMMMMM--MMMMTMMMSSSS
SSSSIIIIIIIIIITIIIIIIIIDDDCYYYYYHFFFFFFFFFYYYYYrrYYYY----YFFFFFFFFFHYYYYYYYYYYYYYYYYYCMMMMM---MMMMMMMMSSSS
SSSSIIITIIIIIIIIIIIIIIIIDDCYYYYYHFFFFFFFFFYYYYYrrYYYY--YYYHFFFLFFFFHHHHHHHYYYTYYYYYYYCDDDMM--MMMMMMMMMSSSS
SSSSIIIIIIIIIIIIIIHHFHHDDDCCYYYYHFFFFFFFFHYYYYrrrYYYY--YYYHFFFFFFFFHFFFFFHYYYYYYYYYYYCDDDDD--DDDMMMMMMSSSS
SSSSIIIIIITIIIIIIIHFFFHDDDDCYYYYHFFFFFHHHHYYYrrrYYYYY--YYYHFFFFFFFFFFFFFFHYYYYYYYYCYYCDDDDDD---DDDDDDDSSSS
SSSSIIIIIIIIIIIIIIHFFFHIIDDCYYYYHFFFHHHYYYrrrrrYYYYY---YYYHFFFFFFFFHFFFFFHYYYYYYYYCYYCDDDDDDDD--DDDDDDSSSS
SSSSIITIIIIITIIIIIHFFFHIIDDCTYYYHHHHHYrrrrrrrrYYYYYY--YYYYHHHHHHHHHHHHHHHHYCCCCCCCCCCCDDDHHHHHD-DDDDDDSSSS
SSSSIIIIIIIIIIIIIIHFFFHIIDDCYYYTYYYYYrrrYYYYYYYYYY----YYYYYYYYYYYYYYYYYYYYYCDDDDDDTDDDDDDHFFFHD--DDDDDSSSS
SSSSIIIIIIIIIIIIIIHHHHHIIDDCYYYYYYYrrrYYYYYYYYYYYY--YYYYYYYYYYTYYYYYYYYYYYYCDDDDDDDDDDDDDHFFFHDD-DDDDDSSSS
SSSSIIHHFHHIIIIIIIIIIIIIIDDCYYYYYYYrrYYYYYYYYYYHHHHHYYYYYYYCCCCCCCCCCCCCCCCCDDDDDDDDDDDDDHHHHH---DDDDDSSSS
SSSSIIHFFFHIIIIIITIIIIIIDDDCCCCCCCCCCCCCCCCYYYYHFFFHYYYYYYCCDDDDDDDCCCCCCDDDDHHHHHHHHHDDDDDD---DDDDDDDSSSS
SSSSIIHFLFHIIIITIIIIIIIIDDTDDDDDDDrrDDDDDCCYYYYHFFFHYYYTYYCDDDDDDDDDDDDDDDDDDHFFFFFFFHDDDDD--DDDDDDDDDSSSS
SSSSIIHHHHHIIIIIIIIIIIIIIIDDDDDDDDrrDDDDDCCYTYYHFFFHYYYYYCCDDDDDDDDDDDDDDDDDDHFFFFFFFHDDDD--DccccccDDDSSSS
SSSSIIIIIIIIIIIIIIIIIIIIIIIIIDDDDrrDDDDDDCCYYYYHHHHHYYYYYCCDDDDDDDDTDDDDDDDDDHHHHHHHHHDDD--DDcFFFFcDDDSSSS
SSSSIIIITIIIITIIIIIIIIIIIII-IIIrrrDDDDDDDCCCCCCCCCCCCCCCCCCDDDDDDDDDDDDDDDDDDDDDDDDDDDD---DDDcFFFFcDDDSSSS
SSSSIIHFFIIIIIIITIIIIIIIIHII-IIrrrrDDDDTDDDDDDDDDDDDDCDDDDDDDDDDDTDDDDDDDDDDDDDDDDDDDD--DDDDDcFFFFcDDDSSSS
SSSSIIHFFFFIIIFFHIIIIIIIIII-IIIrrDDDDDDDDDDDDDDDDDDDDDDDDDDDDDDDDDDDDDDDDDDDD---DDDDD--DDDDDDcFFFFcDDDSSSS
SSSSIIHFFFFIIIFFHIIIII-IIIIIIIIrrDDDDDDDDDDDDDDDDDDDDDDDDDDDDDDDDDDDDDD-------D----------DDDDccccccDDDSSSS
SSSSIIHHHHHIIIHHHIIIIII-IIIIIIIrrDDDDDDDDDDDDDDDDDDDDDTDDDTDDDDDTDDDTD--DDDDTDTDDDDDDDDD-DDDDDDDDDDDDDSSSS
SSSSIIIIIIIIICIIIIIIIII-IIIIIIrrDDDDDDDDDDDDDDDDDDDLDDDDDDDDDDTDDDD----DDTDDDDDTDDDDDDDD--DDDDDDDDDDDDSSSS
SSSSIICIIIIFIIIIIIIII-IIIIIIIIrrDDDDDDDDDDDDDDDDDDDDDDDDDDDDDDDDDD--TDDDDDDDDDDDTDDDDDDDD-DDDDDDDDDDDDSSSS
SSSSIIIFIIIIIIIIIIIIIIIIIIIIIIrrDDDDDDDDDDDDDDDDDDDDDDDDDDDDDDDD---DDDTDDDDDDDTDDDDTDDSSSBSSSDDDDDDDTDSSSS
SSSScccIIIIIIIIII----I-I--BBBBBBB--DDDDDDDDDDDDDDDDDDDDDDDDDDD---DDDDDDHHHFHHDDDTDDDDTSSSBSSSDDDDDDDDDSSSS
SSSSIIcccccIIII-I-IIIII-IIIrrrrDDD---------DDDDDDDDDDDDDDDDD---DDTDDDDDHLFFFHDDDDDTTDDSSBBBSSDDDDDDDDDSSSS
SSSSIIIIIIIccIIIIIHHHIIIIIrrDDDDDDDDDDDDDD----DDDDDDDDDD-----DDDDDDDTDDHFFFFHDTTDDDDDDBBBxBBBDDDDDDDDDSSSS
SSSSIIIIIIIIIIIIIIIIHIIIIIrDDDDDDDDDDTDDDDDDD---DDDDD----DDDDDDTDDDDDDDHFFFFHDDDDTDDTTSSBBBSSDDDDDDDDDSSSS
SSSSIIIIIIIIIIccIIIIHIIIIrrrDDDDDDDDDDDDDDDDDDD-------DDDDDDDDDDDDDTDDDHHHHHHDDTDDDDDDSSSBSSSDDDDDDDDDSSSS
SSSSIIIIITIIIIIccIIIIIIIIrrrDDDDDDDDDDDDDDDDDD------DDDDDDDDDDDDTDDDDDDTDDDDDDDDDDTDDTSSSBSSSDDDDDDDDDSSSS
SSSSIIIIIIIIIIIIcIIIIIIIIrrrDDDDDHHHFHHHDDD---DDDDDDDDDDDTDDDDDDDDDTDDDDTDDDDTDTDDDDDDDDDDDDDDDDDDDDDDSSSS
SSSSIIIIIxIIIIIIccIIIIIIIrDDDDDDDHFFFFFHDDDDDDDDDDDDDDDDDDDDDDDDDDDTDDDDDDTTDDDDDDDDDDDDDDDDDDDDDDDDDDSSSS
SSSSIIIIIIIIIIIIIcIIIIIIrrDDDDDDDHFFFFFHDDDDDDDDDDDDDDDDDDDDDDDDDDDDDDDDDDDDDDDDDDDDDDDDDDDDDTDDDDDDDDSSSS
SSSSITIIIIIIIIIIIcIIIIIrrDDDDDDDDHFFFFFHDDDDDDTDDDDDDDDDDDDDDTDDDDDDDDDDDDDDDDDDDDDDDDDDDDDDDDDDDDDDDDSSSS
SSSSIIIIIIIIIIIIIccIIrrDDDDDDDDDDHHHHHHHDDDDDDDDDDDDDDDDDDDTDDDDDDDDDDDDDTDDDDDDDDDDDDDDDDDTDDDDDDDDDDSSSS
SSSSIIIIIIIIIIIIIIcrrrDDDDDDDDDDDDDDDDDDDDDDDDDDDDDDDDDDDDDDDDDDDDDDDDDDDDDDDDDDDDDDDDDDDDDDDDDDDDDDDDSSSS
SSSSLIIIIIIIIIIIIIcrDDDDDDDDDDDDDDDDDDDDDDDDDDDDDDDDDDDDDDDDDDDDDDDDDDDDDDDDDDDDDDDDDDDDDDDDDDDDDDDDDDSSSS
SSSSSSSSSSSSSSSSSSSSSSSSSSSSSSSSSSSSSSSSSSSSSSSSSSSSSSSSSSSSSSSSSSSSSSSSSSSSSSSSSSSSSSSSSSSSSSSSSSSSSSSSSS
SSSSSSSSSSSSSSSSSSSSSSSSSSSSSSSSSSSSSSSSSSSSSSSSSSSSSSSSSSSSSSSSSSSSSSSSSSSSSSSSSSSSSSSSSSSSSSSSSSSSSSSSSS
SSSSSSSSSSSSSSSSSSSSSSSSSSSSSSSSSSSSSSSSSSSSSSSSSSSSSSSSSSSSSSSSSSSSSSSSSSSSSSSSSSSSSSSSSSSSSSSSSSSSSSSSSS
SSSSSSSSSSSSSSSSSSSSSSSSSSSSSSSSSSSSSSSSSSSSSSSSSSSSSSSSSSSSSSSSSSSSSSSSSSSSSSSSSSSSSSSSSSSSSSSSSSSSSSSSSS