SSSSSSSSSSSSSSSSSSSSSSSSSSSSSSSSSSSSSSSSSSSSSSSSSSSSSSSSSSSSSSSSSSSSSSSSSSSSSSSSSSSSSSSSSSSSSSSSSSSSSSSSSS
SSSSSSSSSSSSSSSSSSSSSSSSSSSSSSSSSSSSSSSSSSSSSSSSSSSSSSSSSSSSSSSSSSSSSSSSSSSSSSSSSSSSSSSSSSSSSSSSSSSSSSSSSS
SSSSSSSSSSSSSSSSSSSSSSSSSSSSSSSSSSSSSSSSSSSSSSSSSSSSSSSSSSSSSSSSSSSSSSSSSSSSSSSSSSSSSSSSSSSSSSSSSSSSSSSSSS
SSSSSSSSSSSSSSSSSSSSSSSSSSSSSSSSSSSSSSSSSSSSSSSSSSSSSSSSSSSSSSSSSSSSSSSSSSSSSSSSSSSSSSSSSSSSSSSSSSSSSSSSSS
SSSSLEEEEEEEEEEEEEEEEEEEEEEEEcEEEEEEEEEEEEEEEEEEEEEEEEEEEEEEEEEEEEEEEEEEEEMMMMMMMMMMMMMMMMMMMMMMMMMrrMSSSS
SSSSEEEEEEEEEEEEEEEEEEEEEEEEEcEEEEEEEEEEEEEEEEEEEEEEEHHHHHHHHHHEEEEEEEEEEMMMMMMMMMMMMMMMMMMMMMMMrrrrMMSSSS
SSSSEEEEEEEEEEEEEEEEEEEEEEcccEEEEEEEEEEEEEEEEEEEEEEEEHFFFFFFFFHEEEEEEEEEMM0MMMMMMMMMMMMMMMMMMMrrrMMMMMSSSS
SSSSEEEEEEEEEEEEEEEEEEEEEccEEEEEEEEEEEEEEEEEEEEEEEEEEHFFFFFFFFHEEEEEEMMMM0MM0MMMMMMMMMMMMMMMMMrrMMMMMMSSSS
SSSSEEEEEEEEEEEEEEEEEEEEcEEEEEEEEEEEEEEEEEEEEEEEEEEEEHFFFFFLFFHEEEEEEMMMMMM0MMMMMMMMMMMMMMMMMrrrMMMMMMSSSS
SSSSEEEEEEEEEEEEEEEEEEEEEEEEEEEEEEEEEEEEEEEEEEEEEEEEEHFFFFFFFFHEEEEEEMMMMMMMMMMMMMMMMMMMMMMrrrrMMMMMMMSSSS
SSSSEEEEEEEEEEEEEEEEcEEEEEEEEEEEEEEEEEEEEEEEEEEEEEEEEHFFFFFFFFHEEEEEEMMMMMMMMMMMMMMMMMMMMMrrMMMMMMMMMMSSSS
SSSSEEEEEEEEEEEEEEEccEEE--EEEEEEEEEEEEEEEEEEEEEEEEEEEHFFFFFFFFHEEEEEEMMMMMMMMMMMMMMMMMMMMrrMMMMMMMMMMMSSSS
SSSSEEEEEEEEEEEEEEccEEEEE---EEEEEEEEEEEEEEEEEEEEEEEEEHFFFFFFFFHEEEEEEMMMMMMMMMMMMMMMMMMMMrrMMMMMMMMMMMSSSS
SSSSEEEEEEEEEEEEcccEEEEEEEE--EEEEEEEEEEEEEEEEEEEEE-EEHFFFFFFFFHEEEEEEMMMMMMMMMMMMMMMMMMMMrrMMMMMMMMMMMSSSS
SSSSEEEEEEEEEEEccEEEEEEEEEEE---EEEEEEEEEEEEEEEEEE--EEHFFFFFFFFHEEEEEEMMMMMMMMMMMMMMMMMMMMrrMMMMMMMMMMMSSSS
SSSSEEEEEEEEEEccEEEEEEEEEEEEEE--EEEEEEEEEEEEEEEE--EEEHHHHHHHHHHEEEEEMMMMMMMMMMMMMMMMMMMMrrrMMMMMMMMMMMSSSS
SSSSEEEEEEEEEccEEEEEEEEEEEEEEEE--EEEEEEEEEEEEEE--EEEEEEEEEEEEEEEEEEEMMMMMMMMMMMMMMMMMMMMrrMMMMMMMMMMMMSSSS
SSSSccccccccccEEEEEEEEEEEEEEEEEE--EEEEEEEEEEEE--EEEEEEEEEEEEEEEEEEEMMMMMMMMMMMMMMMMMMMrrrrMMMMMMMMMMMMSSSS
SSSSEEEEEEEEEEEEHHHHHHHHHHEEEEEE--EEEEEEEEEE---EEEEEEEEEEEEEEEEEEMMMMMMMMMM---------BBBBBBBB-----MMMMMSSSS
SSSSEEEEEEEEEEEEHFFFFFFFFHEEEEEE--EEEEEEEEE--EEEEEEEEEEEEEEEEEEEEMMMMMMMMMM---------BBBBBBBB-----MMMMMSSSS
SSSSEEEEEEEEEEEEHFFFFFFFFHEEEEEE--EEEEEEEE--EEEEEEEEEEEEEEEEEEEEMMMMMMMMMMM-MMMMMMMMMMMrMMMMMMM--MMMMMSSSS
SSSSEEEEEEEEEEEEHFFFFFFFFHEEEEEE--EEEEEEE--EEEEEEEEEEEEEEEEEEEE-------------MMRMMMMMMMMrMMMMMMM--MMMMMSSSS
SSSSEEEEEEEEEEEEHFFLFFFFFHE--------------------EEEEEEEEEEEEEEE--------------SSSSSSSSSSSSMMMMMMM--MMMMMSSSS
SSSSEEEEEEEEEEEEHFFFFFFFFHE-------------------------------------MMMMMMMMMMMSSSSSSSSSSSSSSMMMMMM--MMMMMSSSS
SSSSEEEEEEEEEEEEHFFFFFFFFHEEEEEEE-EEEEEEEEEEEEE---------------MMHHHHHHHHMMRSSSSSSSSSSSSSSMMMMMM--MMMMMSSSS
SSSSEEEEEEEEEEEEHFFFFFFFFHEEEEEEE--EEEEEEEEEEEEEEEEEEE--EEMMMMMMHLFFFFFHMMRSSSSSSSSSSSSSSMMMMMM--MMMMMSSSS
SSSSEEEEEEEEEEEEHFFFFFFFFHEEEEEEEE--EEEEEEEEEEEEEEEEEE--EMMMMMMMHFFFFFFHMMMSSSSSSSSSSSSSSMMMMM--MMMMMMSSSS
SSSSEEEEEEEEEEEEHHHHHHHHHHEEEEEEEEE-EEEEEEEHHHHHHHHHEE--EMMMMMMMHFFFFFFHMMMSSSSSSSSSSSSSSMMMMM--MMMMMMSSSS
SSSSEEEEEEEEEEEEEEEEEEEEEEEEEEEE-----EEEEEEHFFFFFFFHEE--EMMMMMMMHFFFFFFHMMMMMMSSSSSSSSSMMMMMMM--MMMMMMSSSS
SSSSEEEEEEEEEEEEEEEEEEEEEEEEEE---EEE-EEEEEEHFFFFFFFHEE--EMMMMMMMHHHHHHHHMMMMMMMMMrrMMMMMMMMMM--MMMMMMMSSSS
SSSSEEEEEEEEEEEEEEEEEEEEEEEEE---EEEE----EEEHHHHHHHHHEE--EMMMMMMMMMMMMMMMMMMMMMMMrrrMMMMMMMMMM--MMMMMMMSSSS
SSSSEEEEEEEEEEEEEEEEEEEEEEE---EEEEEEEEE---EEEEEEEMMMMM--MMMMMMMMMMMMMMMMMMMMMMMrrrrMMMMMMMMMM--MMMMMMMSSSS
SSSSEEEEEEEEEEEEEEEEEEEEE---EEEEEEHHHHHHE--EEEEEMMMHHHHHHHMMMMMMMMMMMMMMMMMMrrrrrMMMMMMMMMMMM--MMMMMMMSSSS
SSSSEEEEEEEEEEEEEEEEEEEEE--EEEEEEEHFFFFHEE--EMMMMMMHFFFFFHMMMMMMMMMMMMMMMMMrrrrMMMMMMMMTMMMMM--MMMMMMMSSSS
SSSSEEEEEEEEEEEEEEEEEEEE---EEEEEEEHFFFFHEEEMMMMMMMMHFFFFFHMMMMMMMMMMMMMMMrrrMMMMMMMMMMMMMMMMM--MMMMMMMSSSS
SSSSEEEEEEEEEHHHHHHHHE---EEEEEEEEEHHHHHHMMMMMMMMMMMHHHHHHHMMMMMMMMMMMMMrrrMMMMMMMMMMMMMMMMMMM--MMMMMMMSSSS
SSSSEEEEEEEEEHFFFFFFHE--EEEEEEEEEEEEEEMMMMMMMMMMMMMMMMMMMMMMMMMMMMMMMMrrrMMMMMMMMMMMMMMMMMMMM--MMMMMMMSSSS
SSSSEEEEEEEEEHFFFFFFHEEEEEEEEEEEEEEEEMMMMMHHHHHHHHMMMMMMMMMMMMMMMMMMrrrrMMMMMMMMMMMMMMMMM------MMMMMMMSSSS
SSSSEEEEEEEEEHFFFFFFFEEEEEEEEEEMMMMMMMMMMMHFFFFFFHMMMMMMMMMMMMMMMMrrrMMMMMMMMMMMMMMMM--------MMMMMMMMMSSSS
SSSSEEEEEEEEEHFFFFFFHEEEEEEMMMMMMMMMMMMMMMHFFFFFFHM------------BBBBBBB-------------------MM--MMMMMMMMMSSSS
SSSSEEEEEEEEEHHHHHHHHEEEEMMMMMMMMMMMMMMMMMHHHHHHHHM------------BBBBBBB----------------MMMMM--MMMMMMMMMSSSS
SSSSEEEEEEEEEEEEEEEEEEEMMMCCCCCCCCCCCCCCCCCCCCMMMMM--MMMMMMMMMMMMrrMMMMMMMMMMMMMMMMMMMMMMMM--MMMMMMMMMSSSS
SSSSEEEEEEEEEEEEEEEEMMMMMMCMMMMMMMMMMMMMMMMMMCMMMMMM--MMMMMMMMMMMrrMMMMMMMMMMMMMMMMMMMMMMMM--MMMMMMMMMSSSS
SSSSEEEEEEEEEEEEEEEMMMMMMMCMMM-------------MMCMMMMMMM--MMMMMMMMrrrMMMMMMMMMMMMMMMMMMMMMMMMM--MMMMMMMMMSSSS
SSSSEEEEEEEEEEEEEEEMMMMMMMCMM--MCCCCCCCCMM--MCCCCCCCC--MMMMMMMMrrrMMMMMMMMMMMMMMMMMMMMMMMMM--MMMMMMMMMSSSS
SSSSEEEEEEEEEEEEEEMMMMMMMMCMM--MCFFFFFFCMMM------MMMMCCCCMMMMMMrrMMMMMMMMMMMMMMMMMMMMMMMMMM--MMMTMMMMMSSSS
SSSSEEEEEEEEEEEEEMMMMMMMMMCMM--MCFFFFFFCMMM------------MCCCCCCCCCCCCCCCMMMMMMMMMMMMMMMMMMMM--MMMMMMMMMSSSS
SSSSEEEEEEEEEEEEMMMMMMMMMMCMM--MCFFFFFFCMMMMMMMMMMM----MMrrrrrMMMMMMMMCCCCCCCCCCMMMMMMMMMMM--MMMMMMMMMSSSS
SSSSEEEEEEEEMMMMMMMMMMMMMMCMM--MCCFFCCCCCCCCCCCCCCMMM--MMMrrMMMMMMMMMMMMMMMMMMMCMMMMMMMMMMM--MMMMMMMMMSSSS
SSSSMMMMMMMMMMMMMMMMMMMMMMCMM--MCFFFCFFFFFFFFFFFFCMMM--MMrrrMMMMHHHHHHHHHHMMMMMCCCCMMMMMMMM--MMMMMMMMMSSSS
SSSSMMMMMMMMMMMMMMMMMMMMMMCMM--MCCCCCFFFFFFFFFFFFCMMM--rrrrMMMMMHFFFFFFFFHMMMMMMMMCCMMMMMMM--MMMMMMMMMSSSS
SSSSMMMMMMMMMMSSSSSSSMMMMMCMM--MMMMMCFFFFFFFFFFFFCMMM--rrrMMMMMMHFFFFFFFFHMMMMMMMMMCMMMMMMM--MMMMMMMMMSSSS
SSSSMMMMMMMMMSSSSSSSSSSMMMCMM--MMMMMCFFFFFFFFFFFFCMM---rrrMMMMMMHFFFFFFFFHMMMMMMMMMCMMMMMMM--MMMMMMMMMSSSS
SSSSMMMMMMMSSSSSSSSSSSSMMMCMM--MMMMMCFFFFFFFFFFFFCM--BBBBBBBMMMMHFFFFFFFFHMMMMMMMMMCCMMMMMM--MMMMMMMMMSSSS
SSSSMMMMMSSSSSSSSSSSSSSMMMCM-------MCFFFFFFFFFFFFCM--BBBBBBBMMMMHFFFFFFFFHHHHHHMMMMMCMMMMMM--MMMMMMMMMSSSS
SSSSMMMMMSSSSSSSSSSSSSSMMMCM-------MCFFFFFFFFFFFFCMMMMMrrrMMM-MMHFFFFFFFFHLFFFHMMMMMCMMMMMM--MMMMMMMMMSSSS
SSSSMMMMMSSSSSSSSSSSSSMMMMCM--MMMMMMCFFFFFFFFFFFFCMMMMrrrrMM--MMHFFFFFFFFHFFFFHMMMMMCMMMMMM--MMMMMMMMMSSSS
SSSSMMMMMSSSSSSSSSSSSMMMMMCM--MMMMMMCFFFFFFFFFFFFCMMMrrrMMMMM-MMHFFFFFFFFHFFFFHMMMMMCMMMMMM--MMMMMMMMMSSSS
SSSSMMMMMMSSSSSSSSSSMMMMMMCM--MCCCCCCFFFFFFFFFFFFCMMMrrrMMMMM-MMHHHHHHHHHHHHHHHMMMMMCMMMMMM--MMMMMMMMMSSSS
SSSSMMMMMMMMMMMMMMMMMMMMMMCM--MCFFFFCFFFFFFFFFFFFCMMMrrMMMM-------------------------C---------MMMMMMMMSSSS
SSSSMMMMMMMMMDMMMMMDDDDDDDCM--MCFFFFCFFFFFFFFFFFFCMMMrrMM---------------------------C---------MMMMMMMMSSSS
SSSSMMMMMMMDDDDDDDDDDDDDDDCM--MCCCCCCCCCCCCCCCCCCCMMMrrM---MMM--MMMMMM-MMMMHHHHHHMMMCMMMMMMM--MMMMMMMMSSSS
SSSSMMMMMMDDDDDDDDDDDDDDDDCM---------------MMMMMMMMMrrrM--MMMM--MMMMMM--MMMHFFFFHMMMCMMMMMMM--MMMMMMMMSSSS
SSSSDDDDDDDDDDDDDDDDDDDDDDCM------------------BBBBBBBBB---MMMMMMMMMMMMM----HFFFFHMMMCCMMMMMM--MMMMMMMMSSSS
SSSSDDDDDDDDDDDDDDDDDDDDDDCMMMMMHHHHHHHHHH----BBBBBBBBB---HHHHHHHHHHMMMMMMMHFFFFHMMMMCMMMMMM--MMMMMMMMSSSS
SSSSIIIIIIIIIIDDDDDDDDDDDDCMMMMMHFFFFFFFFHMMMMMMrrrMMMM--MHFFFFFFFFHMMMMMMMHHHHHHMMMMCMMMMMM--MMMMMMMMSSSS
SSSSIIIIIIIIIIIIIIDDDDDDDDCMMMMMHFFFFFFFFHMMMMMrrrMMMMM--MHFFFFFFFFHMMMMMMMMMMMMMMMMMCMMMMMM--MMMMMMMMSSSS
SSSSIIIIIIIIIIIIIIIIIIDDDDCMMMMMHFFFFFFFFHMMMMMrrMMMM----MHFFFFFFFFHMMMMMMMMMMMMMMMMMCMMMMMM--MMMMTMMMSSSS
SSSSIIIIIIIIIIIIIIIIIIIDDDCMMMMMHFFFFFFFFHMMMMMrrMMMM----MHFFFFFFFFHMMMMMMMMMMMMMMMMMCMMMMM---MMMMMMMMSSSS
SSSSIIIIIIIIIIIIIIIIIIIIDDCMMMMMHFFFFFFFFHMMMMMrrMMMM--MMMHFFFFFFFFHHHHHHHMMMMMMMMMMMCDDDMM--MMMMMMMMMSSSS
SSSSIIIIIIIIIIIIIIHHHHHDDDCCMMMMHFFFFFFFFHMMMMrrrMMMM--MMMHFFFFFFFFHFFFFFHMMMMMMMMMMMCDDDDD--DDDMMMMMMSSSS
SSSSIIIIIIIIIIIIIIHFFFHDDDDCMMMMHFFFFFHHHHMMMrrrMMMMM--MMMHFFFFFFFFHFFFFFHMMMMMMMMCMMCDDDDDD---DDDDDDDSSSS
SSSSIIIIIIIIIIIIIIHFFFHIIDDCMMMMHFFFHHH000rrrrrMMMMM---MMMHFFFFFFFFHFFFFFHMMMMMMMMCMMCDDDDDDDD--DDDDDDSSSS
SSSSIIIIIIIITIIIIIHFFFHIIDDCMMMMHHHHH0rrrrrrrrMMMMMM--MMMMHHHHHHHHHHHHHHHHMCCCCCCCCCCCDDDHHHHHD-DDDDDDSSSS
SSSSIIIIIIIIIIIIIIHFFFHIIDDCMMMMMMMMMrrrMMMMMMMMMM----MMMMMMMMMMMMMMMMMMMMMCDDDDDDDDDDDDDHFFFHD--DDDDDSSSS
SSSSIIIIIIIIIIIIIIHHHHHIIDDCMMMMMMMrrrMMMMMMMMMMMM--MMMMMMMMMMMMMMMMMMMMMMMCDDDDDDDDDDDDDHFFFHDD-DDDDDSSSS
SSSSIIHHHHHIIIIIIIIIIIIIIDDCMMMMMMMrrMMMMMMMMMMHHHHHMMMMMMMCCCCCCCCCCCCCCCCCDDDDDDDDDDDDDHHHHH---DDDDDSSSS
SSSSIIHFFFHIIIIIIIIIIIIIDDDCCCCCCCCCCCCCCCCMMMMHFFFHMMMMMMCCDDDDDDDCCCCCCDDDDHHHHHHHHHDDDDDD---DDDDDDDSSSS
SSSSIIHFLFHIIIIIIIIIIIIIDDDDDDDDDDrrDDDDDCCMMMMHFFFHMMMMMMCDDDDDDDDDDDDDDDDDDHFFFFFFFHDDDDD--DDDDDDDDDSSSS
SSSSIIHHHHHIIIIIIIIIIIIIIIDDDDDDDDrrDDDDDCCMMMMHFFFHMMMMMCCDDDDDDDDDDDDDDDDDDHFFFFFFFHDDDD--DccccccDDDSSSS
SSSSIIIIIIIIIIIIIIIIHHHHHIIIIDDDDrrDDDDDDCCMMMMHHHHHMMMMMCCDDDDDDDDDDDDDDDDDDHHHHHHHHHDDD--DDcFFFFcDDDSSSS
SSSSIIIIIIIIIIIIIIHIIIIIFII-IIIrrrDDDDDDDCCCCCCCCCCCCCCCCCCDDDDDDDDDDDDDDDDDDDDDDDDDDDD---DDDcFFFFcDDDSSSS
SSSSIIIIIIIIIIIITIHIIFIIIHII-IIrrDDDDDDDDDDDDDDDDDDDDCDDDDDDDDDDDDDDDDDDDDDDDDDDDDDDDD--DDDDDcFFFFcDDDSSSS
SSSSIIIIIIIIIIIIIIHIIIIIIII-IIIrrDDDDDDDDDDDDDDDDDDDDDDDDDDDDDDDDDDDDDDDDDDDD---DDDDD--DDDDDDcFFFFcDDDSSSS
SSSSIIICCCCCIIIIIIIHIF-IIIIIIIIrrDDDDDDDDDDDDDDDDDDDDDDDDDDDDDDDDDDDDDD-------D----------DDDDccccccDDDSSSS
SSSSIIIIFFIIFCIIIIIIHII-IIIIIIIrrDDDDDDDDDDDDDDDDDDDDDDDDDDDDDDDTDDDTD--DDDDTDTDDDDDDDDD-DDDDDDDDDDDDDSSSS
SSSSIICIIFIIICCIIIIIIII-IIIIIIrrDDDDDDDDDDDDDDDDDDDDDDDDDDDDDDTDDDD----DDTDDDDDTDDDDDDDD--DDDDDDDDDDDDSSSS
SSSSIICIIIIFIICIIIHII-IIIIIIIIrrDDDDDDDDDDDDDDDDDDDDDDDDDDDDDDDDDD--TDDDDDDDDDDDTDDDDDDDD--DDDDDDDDDDDSSSS
SSSSIIIFIIIIIIIIIIHHIIIIIIIIIIrrDDDDDDDDDDDDDDDDDDDDDDDDDDDDDDDD---DDDTDDDDDDDTDDDDTDDDDDD-DDDDDDDDDDDSSSS
SSSScccIIIICICIII----I-I--BBBBBBB--DDDDDDDDDDDDDDDDDDDDDDDDDDD---DDDDDDHHHHHHDDDTDDDDTDDDD-DDDDDDDDDDDSSSS
SSSSIIcccccIIII-I-IIIII-IIIrrrrDDD---------DDDDDDDDDDDDDDDDD---DDTDDDDDHLFFFHDDDDDTTDDDDDD---DDDDDDDDDSSSS
SSSSIIIIIIIccIIIIIHHHIIIIIrrDDDDDDDDDDDDDD----DDDDDDDDDD-----DDDDDDDTDDHFFFFHDTTDDDDDDDDDDDD--DDDDDDDDSSSS
SSSSIIIIIIIIcIIIIIIIHIIIIIrDDDDDDDDDDDDDDDDDD---DDDDD----DDDDDDTDDDDDDDHFFFFHDDDDTDDTTDDDDDDD-DDDDDDDDSSSS
SSSSIIIIIIIIIcccIFIIIIIIIrrrDDDDDDDDDDDDDDDDDDD-------DDDDDDDDDDDDDTDDDHHHHHHDDTDDDDDDDDDDDDDDDDDDDDDDSSSS
SSSSIIIIIIIIIIIccIIFIIIIIrrrDDDDDDDDDDDDDDDDDD------DDDDDDDDDDDDTDDDDDDTDDDDDDDDDDTDDTDDDDDDDDDDDDDDDDSSSS
SSSSIIIIIIIIIIIIcIIIIFHIIrrrDDDDDHHHHHHHDDD---DDDDDDDDDDDDDDDDDDDDDTDDDDTDDDDTDTDDDTDDDDDDDDDDDDDDDDDDSSSS
SSSSIIIIIIIIIIIIccIIHHHIIrDDDDDDDHFFFFFHDDDDDDDDDDDDDDDDDDDDDDDDDDDDDDDDDDTTDDDDDDDDDDDDDDDDDDDDDDDDDDSSSS
SSSSIIIIIIIIIIIIIcIIIIIIrrDDDDDDDHFFFFFHDDDDDDDDDDDDDDDDDDDDDDDDDDDDDDDDDDDDDDDDDDDDDDDDDDDDDDDDDDDDDDSSSS
SSSSIIIIIIIIIIIIIcIIIIIrrDDDDDDDDHFFFFFHDDDDDDDDDDDDDDDDDDDDDDDDDDDDDDDDDDDDDDDDDDDDDDDDDDDDDDDDDDDDDDSSSS
SSSSIIIIIIIIIIIIIccIIrrDDDDDDDDDDHHHHHHHDDDDDDDDDDDDDDDDDDDDDDDDDDDDDDDDDDDDDDDDDDDDDDDDDDDDDDDDDDDDDDSSSS
SSSSIIIIIIIIIIIIIIcrrrDDDDDDDDDDDDDDDDDDDDDDDDDDDDDDDDDDDDDDDDDDDDDDDDDDDDDDDDDDDDDDDDDDDDDDDDDDDDDDDDSSSS
SSSSLIIIIIIIIIIIIIcrDDDDDDDDDDDDDDDDDDDDDDDDDDDDDDDDDDDDDDDDDDDDDDDDDDDDDDDDDDDDDDDDDDDDDDDDDDDDDDDDDDSSSS
SSSSSSSSSSSSSSSSSSSSSSSSSSSSSSSSSSSSSSSSSSSSSSSSSSSSSSSSSSSSSSSSSSSSSSSSSSSSSSSSSSSSSSSSSSSSSSSSSSSSSSSSSS
SSSSSSSSSSSSSSSSSSSSSSSSSSSSSSSSSSSSSSSSSSSSSSSSSSSSSSSSSSSSSSSSSSSSSSSSSSSSSSSSSSSSSSSSSSSSSSSSSSSSSSSSSS
SSSSSSSSSSSSSSSSSSSSSSSSSSSSSSSSSSSSSSSSSSSSSSSSSSSSSSSSSSSSSSSSSSSSSSSSSSSSSSSSSSSSSSSSSSSSSSSSSSSSSSSSSS
SSSSSSSSSSSSSSSSSSSSSSSSSSSSSSSSSSSSSSSSSSSSSSSSSSSSSSSSSSSSSSSSSSSSSSSSSSSSSSSSSSSSSSSSSSSSSSSSSSSSSSSSSS